SO sprites/south.xpm

NO sprites/north.xpm

F 46,51,87

EA sprites/east.xpm

C 99,197,218

WE sprites/west.xpm

                         111111111
                        10000000001
                        10000000001
                         100000001
11111    111111111111111111000001
10001    100000000000000000000001
10S01    101111111111111111000001
10001    100000000000000001111111
11011    111111111111111101                           111111
100011111100000000000000001                          10000001
100010000100111111111111111 1111111111111           1000000001
1000000001001               1000000000001          100000000001
1000100001001               100000000000111111111110000000000001
100011111100111111          100000000000000000000000000000000001
100011000000000001          100000000000111111111110000000000001
100011000000000001          1000000000001          100000000001
10001100000000000111111111111000000000001           1000000001
10001100000000000000000000000000011111111            10000001
1000110000000000011111111111110001                    111111
100011000000000001           10001
100000000000000001           10001
100001000000000001           10001
100001000000000001           10001
100011000000000001           10001
100011000000000001          10001
100011000000000001          10001
100011000000000001         10001
100011000000000001        10001
100011111111111111       10001
10001            11111  10001
1001          11100000110001
101         110000000000001
101        10000000000000001
101       1000000000000000001
101111111100000000000000000001
100000000000000000000000000001
111111111100000000000000000001
          1000000000000000001
           10000000000000001
            110000000000011
              11100000111
                 11111
