NO sprites/north.xpm
SO sprites/south.xpm
WE sprites/west.xpm
EA sprites/east.xpm

F 46,51,87
C 99,197,218

11111
10001
10N01
10001
11111
